_____H___W__
SSS_S_SSSS__
B___SBS__S_M
____SBS__S__
_B__SSS_KS__
_M_______S__
_TBT_____SM_
_TTT__+-_B__
_________B__
BSSSSBBSSSB_
_V_____M____
M__<___>_S__
