SSSSSSSSSSSSSSSSSSSSSSSSSSS
S_____SSSTTT__BBB________S
S___SBS__S_M_H___M________S
S_M_SHS__S_BBBB_______W___S
SB__SSS_BS________SSSSSSS_S
SM_______S_____T______S___S
STBT_____STSSSTT______B___S
STTT__+-_B___H___T____B___S
S________B_______M____B___S
SSSSSBBSSSB_____SSS___T__MS
SV_____M______T_______TM__S
SSSSSSSSSSSSSSSSSSSSSSSSSSS
