_____SSSTTT__BBB________S
___SBS__S_M_H___M________
_M_SHS__S_BBBB_______W___
B__SSS_BS________SSSSSSS_
M_______S_____T______S___
TBT_____STSSSTT______B___
TTT__+-_B___H___T____B___
________B_______M____B___
SSSSBBSSSB_____SSS___T__M
V_____M______T_______TM__
